NO     ./textures/purplestone.xpm
SO ./textures/bluestone.xpm
WE ./textures/wall_1.xpm
EA ./textures/wall_2.xpm

F 220,100    ,0
C 225,      30,0

111111
100001
100N01
111111
