NO ./textures/purplestone.xpm
SO ./textures/bluestone.xpm
WE ./textures/wall_1.xpm
EA ./textures/wall_2.xpm

F 220,100,0
C 225,30,0

        1111111111111111111111111111111111111111111111111111111111111111111111111111111111111111111111
        1000000000111000000000111000000000111000000000111000000000111000000000111000000000111000000001
  1     1011000000111000000000111000000000111000000000111000000000111000000000111000000000111000000001
  1    10001000000111000000000111000000000111000000000111000000000111000000000111000000000111000000001
111111111011000001110000000000111000000000111000000000111000000000111000000000111000000000111000000001
100000000011000000001110000000111000000000111000000000111000000000111000000000111000000000111000000001
111101111111110100011000000000111000000000111000000000111000000000111000000000111000000000111000000001
111101111111110110001110000000001110000000001110000000001110000000001110000000001110000000001110000001
1100000011011111110001110000000001110000000001110000000001110000000001110000000001110000000001110000001
1000000000000000000000000000000000000000000000000000000000000000000000000000000000000000000000000000001
1111011111111100001110000000001110000000001110000000001110000000001110000000001110000000001110000000001
1100000111010101000111000000000111000000000111000000000111000000000111000000000111000000000111000000001
1100000111010101000111000000000111000000000111000000000111000000000111000000000111000000000111000000001
1111011111111101000111000000000111000000000111000000000111000000000111000000000111000000000111000000001
11110111 1110100001110000000001110000000001110000000001110000000001110000000001110000000001110000000001
11111111 1111100011100000000011100000000011100000000011100000000011100000000011100000000011100000000001
        1000000000111000000000111000000000111000000000111000000000111000000000111000000000111000000001
  1     1011000000111000000000111000000000111000000000111000000000111000000000111000000000111000000001
  1    10001000000111000000000111000000000111000000000111000000000111000000000111000000000111000000001
111111111011000001110000000000111000000000111000000000111000000000111000000000111000000000111000000001
100000000011000000001110000000111000000000111000000000111000000000111000000000111000000000111000000001
111101111111110100011000000000111000000000111000000000111000000000111000000000111000000000111000000001
111101111111110110001110000000001110000000001110000000001110000000001110000000001110000000001110000001
1100000011011111110001110000000001110000000001110000000001110000000001110000000001110000000001110000001
1000000000000000000000000000000000000000000000000000000000000000000000000000000000000000000000000000001
1111011111111100001110000000001110000000001110000000001110000000001110000000001110000000001110000000001
1100000111010101000111000000000111000000000111000000000111000000000111000000000111000000000111000000001
1100000111010101000111000000000111000000000111000000000111000000000111000000000111000000000111000000001
1111011111111101000111000000000111000000000111000000000111000000000111000000000111000000000111000000001
11110111 1110100001110000000001110000000001110000000001110000000001110000000001110000000001110000000001
11111111 1111100011100000000011100000000011100000000011100000000011100000000011100000000011100000000001
        1111111111111111111111111111111111111111111111111111111111111111111111111111111111111111111111
        1000000000111000000000111000000000111000000000111000000000111000000000111000000000111000000001
  1     1011000000111000000000111000000000111000000000111000000000111000000000111000000000111000000001
  1    10001000000111000000000111000000000111000000000111000000000111000000000111000000000111000000001
111111111011000001110000000000111000000000111000000000111000000000111000000000111000000000111000000001
100000000011000000001110000000111000000000111000000000111000000000111000000000111000000000111000000001
111101111111110100011000000000111000000000111000000000111000000000111000000000111000000000111000000001
111101111111110110001110000000001110000000001110000000001110000000001110000000001110000000001110000001
1100000011011111110001110000000001110000000001110000000001110000000001110000000001110000000001110000001
1000000000000000000000000000000000000000000000000000000000000000000000000000000000000000000000000000001
1111011111111100001110000000001110000000001110000000001110000000001110000000001110000000001110000000001
1100000111010101000111000000000111000000000111000000000111000000000111000000000111000000000111000000001
1100000111010101000111000000000111000000000111000000000111000000000111000000000111000000000111000000001
1111011111111101000111000000000111000000000111000000000111000000000111000000000111000000000111000000001
11110111 1110100001110000000001110000000001110000000001110000000001110000000001110000000001110000000001
11111111 1111100011100000000011100000000011100000000011100000000011100000000011100000000011100000000001
        1000000000111000000000111000000000111000000000111000000000111000000000111000000000111000000001
  1     1011000000111000000000111000000000111000000000111000000000111000000000111000000000111000000001
  1    10001000000111000000000111000000000111000000000111000000000111000000000111000000000111000000001
111111111011000001110000000000111000000000111000000000111000000000111000000000111000000000111000000001
100000000011000000001110000000111000000000111000000000111000000000111000000000111000000000111000000001
111101111111110100011000000000111000000000111000000000111000000000111000000000111000000000111000000001
111101111111110110001110000000001110000000001110000000001110000000001110000000001110000000001110000001
1100000011011111110001110000000001110000000001110000000001110000000001110000000001110000000001110000001
1000000000000000000000000000000000000000000000000000000000000000000000000000000000000000000000000000001
1111011111111100001110000000001110000000001110000000001110000000001110000000001110000000001110000000001
1100000111010101000111000000000111000000000111000000000111000000000111000000000111000000000111000000001
1100000111010101000111000000000111000000000111000000000111000000000111000000000111000000000111000000001
1111011111111101000111000000000111000000000111000000000111000000000111000000000111000000000111000000001
11110111 1110100001110000000001110000000001110000000001110000000001110000000001110000000001110000000001
11111111 1111100011100000000011100000000011100000000011100000000011100000000011100000000011100000000001
        1111111111111111111111111111111111111111111111111111111111111111111111111111111111111111111111
        1000000000111000000000111000000000111000000000111000000000111000000000111000000000111000000001
  1     1011000000111000000000111000000000111000000000111000000000111000000000111000000000111000000001
  1    10001000000111000000000111000000000111000000000111000000000111000000000111000000000111000000001
111111111011000001110000000000111000000000111000000000111000000000111000000000111000000000111000000001
100000000011000000001110000000111000000000111000000000111000000000111000000000111000000000111000000001
111101111111110100011000000000111000000000111000000000111000000000111000000000111000000000111000000001
111101111111110110001110000000001110000000001110000000001110000000001110000000001110000000001110000001
1100000011011111110001110000000001110000000001110000000001110000000001110000000001110000000001110000001
1000000000000000000000000000000000000000000000000000000000000000000000000000000000000000000000000000001
1111011111111100001110000000001110000000001110000000001110000000001110000000001110000000001110000000001
1100000111010101000111000000000111000000000111000000000111000000000111000000000111000000000111000000001
1100000111010101000111000000000111000000000111000000000111000000000111000000000111000000000111000000001
1111011111111101000111000000000111000000000111000000000111000000000111000000000111000000000111000000001
11110111 1110100001110000000001110000000001110000000001110000000001110000000001110000000001110000000001
11111111 1111100011100000000011100000000011100000000011100000000011100000000011100000000011100000000001
        1000000000111000000000111000000000111000000000111000000000111000000000111000000000111000000001
  1     1011000000111000000000111000000000111000000000111000000000111000000000111000000000111000000001
  1    10001000000111000000000111000000000111000000000111000000000111000000000111000000000111000000001
111111111011000001110000000000111000000000111000000000111000000000111000000000111000000000111000000001
100000000011000000001110000000111000000000111000000000111000000000111000000000111000000000111000000001
111101111111110100011000000000111000000000111000000000111000000000111000000000111000000000111000000001
111101111111110110001110000000001110000000001110000000001110000000001110000000001110000000001110000001
1100000011011111110001110000000001110000000001110000000001110000000001110000000001110000000001110000001
1000000000000000000000000000000000000000000000000000000000000000000000000000000000000000000000000000001
1111011111111100001110000000001110000000001110000000001110000000001110000000001110000000001110000000001
1100000111010101000111000000000111000000000111000000000111000000000111000000000111000000000111000000001
1100000111010101000111000000000111000000000111000000000111000000000111000000000111000000000111000000001
1111011111111101000111000000000111000000000111000000000111000000000111000000000111000000000111000000001
11110111 1110100001110000000001110000000001110000000001110000000001110000000001110000000001110000000001
11111111 1111100011100000000011100000000011100000000011100000000011100000000011100000000011100000000001
        1111111111111111111111111111111111111111111111111111111111111111111111111111111111111111111111
        1000000000111000000000111000000000111000000000111000000000111000000000111000000000111000000001
  1     1011000000111000000000111000000000111000000000111000000000111000000000111000000000111000000001
  1    10001000000111000000000111000000000111000000000111000000000111000000000111000000000111000000001
111111111011000001110000000000111000000000111000000000111000000000111000000000111000000000111000000001
100000000011000000001110000000111000000000111000000000111000000000111000000000111000000000111000000001
111101111111110100011000000000111000000000111000000000111000000000111000000000111000000000111000000001
111101111111110110001110000000001110000000001110000000001110000000001110000000001110000000001110000001
1100000011011111110001110000000001110000000001110000000001110000000001110000000001110000000001110000001
1000000000000000000000000000000000000000000000000000000000000000000000000000000000000000000000000000001
1111011111111100001110000000001110000000001110000000001110000000001110000000001110000000001110000000001
1100000111010101000111000000000111000000000111000000000111000000000111000000000111000000000111000000001
1100000111010101000111000000000111000000000111000000000111000000000111000000000111000000000111000000001
1111011111111101000111000000000111000000000111000000000111000000000111000000000111000000000111000000001
11110111 1110100001110000000001110000000001110000000001110000000001110000000001110000000001110000000001
11111111 1111100011100000000011100000000011100000000011100000000011100000000011100000000011100000000001
        1000000000111000000000111000000000111000000000111000000000111000000000111000000000111000000001
  1     1011000000111000000000111000000000111000000000111000000000111000000000111000000000111000000001
  1    10001000000111000000000111000000000111000000000111000000000111000000000111000000000111000000001
111111111011000001110000000000111000000000111000000000111000000000111000000000111000000000111000000001
100000000011000000001110000000111000000000111000000000111000000000111000000000111000000000111000000001
111101111111110100011000000000111000000000111000000000111000000000111000000000111000000000111000000001
111101111111110110001110000000001110000000001110000000001110000000001110000000001110000000001110000001
1100000011011111110001110000000001110000000001110000000001110000000001110000000001110000000001110000001
1000000000000000000000000000000000000000000000000000000000000000000000000000000000000000000000000000001
1111011111111100001110000000001110000000001110000000001110000000001110000000001110000000001110000000001
1100000111010101000111000000000111000000000111000000000111000000000111000000000111000000000111000000001
1100000111010101000111000000000111000000000111000000000111000000000111000000000111000000000111000000001
1111011111111101000111000000000111000000000111000000000111000000000111000000000111000000000111000000001
11110111 1110100001110000000001110000000001110000000001110000000001110000000001110000000001110000000001
11111111 1111100011100000000011100000000011100000000011100000000011100000000011100000000011100000000001
1111111111111111111111111111111111111111111111111111111111111111111111111111111111111111111111111111111
        1000000000111000000000111000000000111000000000111000000000111000000000111000000000111000000001
  1     1011000000111000000000111000000000111000000000111000000000111000000000111000000000111000000001
  1    10001000000111000000000111000000000111000000000111000000000111000000000111000000000111000000001
111111111011000001110000000000111000000000111000000000111000000000111000000000111000000000111000000001
100000000011000000001110000000111000000000111000000000111000000000111000000000111000000000111000000001
111101111111110100011000000000111000000000111000000000111000000000111000000000111000000000111000000001
111101111111110110001110000000001110000000001110000000001110000000001110000000001110000000001110000001
1100000011011111110001110000000001110000000001110000000001110000000001110000000001110000000001110000001
1000000000000000000000000000000000000000000000000000000000000000000000000000000000000000000000000000001
1111011111111100001110000000001110000000001110000000001110000000001110000000001110000000001110000000001
1100000111010101000111000000000111000000000111000000000111000000000111000000000111000000000111000000001
1100000111010101000111000000000111000000000111000000000111000000000111000000000111000000000111000000001
1111011111111101000111000000000111000000000111000000000111000000000111000000000111000000000111000000001
11110111 1110100001110000000001110000000001110000000001110000000001110000000001110000000001110000000001
11111111 1111100011100000000011100000000011100000000011100000000011100000000011100000000011100000000001
        1000000000111000000000111000000000111000000000111000000000111000000000111000000000111000000001
  1     1011000000111000000000111000000000111000000000111000000000111000000000111000000000111000000001
  1    10001000000111000000000111000000000111000000000111000000000111000000000111000000000111000000001
111111111011000001110000000000111000000000111000000000111000000000111000000000111000000000111000000001
100000000011000000001110000000111000000000111000000000111000000000111000000000111000000000111000000001
111101111111110100011000000000111000000000111000000000111000000000111000000000111000000000111000000001
111101111111110110001110000000001110000000001110000000001110000000001110000000001110000000001110000001
1100000011011111110001110000000001110000000001110000000001110000000001110000000001110000000001110000001
1000000000000000000000000000000000000000000000000000000000000000000000000000000000000000000000000000001
1111011111111100001110000000001110000000001110000000001110000000001110000000001110000000001110000000001
1100000111010101000111000000000111000000000111000000000111000000000111000000000111000000000111000000001
1100000111010101000111000000000111000000000111000000000111000000000111000000000111000000000111000000001
1111011111111101000111000000000111000000000111000000000111000000000111000000000111000000000111000000001
11110111 1110100001110000000001110000000001110000000001110000000001110000000001110000000001110000000001
11111111 1111100011100000000011100000000011100000000011100000000011100000000011100000000011100000000001
        1111111111111111111111111111111111111111111111111111111111111111111111111111111111111111111111
        1000000000111000000000111000000000111000000000111000000000111000000000111000000000111000000001
  1     1011000000111000000000111000000000111000000000111000000000111000000000111000000000111000000001
  1    10001000000111000000000111000000000111000000000111000000000111000000000111000000000111000000001
111111111011000001110000000000111000000000111000000000111000000000111000000000111000000000111000000001
100000000011000000001110000000111000000000111000000000111000000000111000000000111000000000111000000001
111101111111110100011000000000111000000000111000000000111000000000111000000000111000000000111000000001
111101111111110110001110000000001110000000001110000000001110000000001110000000001110000000001110000001
1100000011011111110001110000000001110000000001110000000001110000000001110000000001110000000001110000001
1000000000000000000000000000000000000000000000000000000000000000000000000000000000000000000000000000001
1111011111111100001110000000001110000000001110000000001110000000001110000000001110000000001110000000001
1100000111010101000111000000000111000000000111000000000111000000000111000000000111000000000111000000001
1100000111010101000111000000000111000000000111000000000111000000000111000000000111000000000111000000001
1111011111111101000111000000000111000000000111000000000111000000000111000000000111000000000111000000001
11110111 1110100001110000000001110000000001110000000001110000000001110000000001110000000001110000000001
11111111 1111100011100000000011100000000011100000000011100000000011100000000011100000000011100000000001
        1000000000111000000000111000000000111000000000111000000000111000000000111000000000111000000001
  1     1011000000111000000000111000000000111000000000111000000000111000000000111000000000111000000001
  1    10001000000111000000000111000000000111000000000111000000000111000000000111000000000111000000001
111111111011000001110000000000111000000000111000000000111000000000111000000000111000000000111000000001
100000000011000000001110000000111000000000111000000000111000000000111000000000111000000000111000000001
111101111111110100011000000000111000000000111000000000111000000000111000000000111000000000111000000001
111101111111110110001110000000001110000000001110000000001110000000001110000000001110000000001110000001
1100000011011111110001110000000001110000000001110000000001110000000001110000000001110000000001110000001
1000000000000000000000000000000000000000000000000000000000000000000000000000000000000000000000000000001
1111011111111100001110000000001110000000001110000000001110000000001110000000001110000000001110000000001
1100000111010101000111000000000111000000000111000000000111000000000111000000000111000000000111000000001
1100000111010101000111000000000111000000000111000000000111000000000111000000000111000000000111000000001
1111011111111101000111000000000111000000000111000000000111000000000111000000000111000000000111000000001
11110111 1110100001110000000001110000000001110000000001110000000001110000000001110000000001110000000001
11111111 1111100011100000000011100000000011100000000011100000000011100000000011100000000011100000000001
        1111111111111111111111111111111111111111111111111111111111111111111111111111111111111111111111
        1000000000111000000000111000000000111000000000111000000000111000000000111000000000111000000001
  1     1011000000111000000000111000000000111000000000111000000000111000000000111000000000111000000001
  1    10001000000111000000000111000000000111000000000111000000000111000000000111000000000111000000001
111111111011000001110000000000111000000000111000000000111000000000111000000000111000000000111000000001
100000000011000000001110000000111000000000111000000000111000000000111000000000111000000000111000000001
111101111111110100011000000000111000000000111000000000111000000000111000000000111000000000111000000001
111101111111110110001110000000001110000000001110000000001110000000001110000000001110000000001110000001
1100000011011111110001110000000001110000000001110000000001110000000001110000000001110000000001110000001
1000000000000000000000000000000000000000000000000000000000000000000000000000000000000000000000000000001
1111011111111100001110000000001110000000001110000000001110000000001110000000001110000000001110000000001
1100000111010101000111000000000111000000000111000000000111000000000111000000000111000000000111000000001
1100000111010101000111000000000111000000000111000000000111000000000111000000000111000000000111000000001
1111011111111101000111000000000111000000000111000000000111000000000111000000000111000000000111000000001
11110111 1110100001110000000001110000000001110000000001110000000001110000000001110000000001110000000001
11111111 1111100011100000000011100000000011100000000011100000000011100000000011100000000011100000000001
        1000000000111000000000111000000000111000000000111000000000111000000000111000000000111000000001
  1     1011000000111000000000111000000000111000000000111000000000111000000000111000000000111000000001
  1    10001000000111000000000111000000000111000000000111000000000111000000000111000000000111000000001
111111111011000001110000000000111000000000111000000000111000000000111000000000111000000000111000000001
100000000011000000001110000000111000000000111000000000111000000000111000000000111000000000111000000001
111101111111110100011000000000111000000000111000000000111000000000111000000000111000000000111000000001
111101111111110110001110000000001110000000001110000000001110000000001110000000001110000000001110000001
1100000011011111110001110000000001110000000001110000000001110000000001110000000001110000000001110000001
100000N000000000000000000000000000000000000000000000000000000000000000000000000000000000000000000000001
1111011111111100001110000000001110000000001110000000001110000000001110000000001110000000001110000000001
1100000111010101000111000000000111000000000111000000000111000000000111000000000111000000000111000000001
1100000111010101000111000000000111000000000111000000000111000000000111000000000111000000000111000000001
1111011111111101000111000000000111000000000111000000000111000000000111000000000111000000000111000000001
11110111 1110100001110000000001110000000001110000000001110000000001110000000001110000000001110000000001
11111111 1111100011100000000011100000000011100000000011100000000011100000000011100000000011100000000001
        1000000000111000000000111000000000111000000000111000000000111000000000111000000000111000000001
  1     1011000000111000000000111000000000111000000000111000000000111000000000111000000000111000000001
  1    10001000000111000000000111000000000111000000000111000000000111000000000111000000000111000000001
111111111011000001110000000000111000000000111000000000111000000000111000000000111000000000111000000001
100000000011000000001110000000111000000000111000000000111000000000111000000000111000000000111000000001
111101111111110100011000000000111000000000111000000000111000000000111000000000111000000000111000000001
111101111111110110001110000000001110000000001110000000001110000000001110000000001110000000001110000001
1100000011011111110001110000000001110000000001110000000001110000000001110000000001110000000001110000001
1000000000000000000000000000000000000000000000000000000000000000000000000000000000000000000000000000001
1111011111111100001110000000001110000000001110000000001110000000001110000000001110000000001110000000001
1100000111010101000111000000000111000000000111000000000111000000000111000000000111000000000111000000001
1100000111010101000111000000000111000000000111000000000111000000000111000000000111000000000111000000001
1111011111111101000111000000000111000000000111000000000111000000000111000000000111000000000111000000001
11110111 1110100001110000000001110000000001110000000001110000000001110000000001110000000001110000000001
11111111 1111100011100000000011100000000011100000000011100000000011100000000011100000000011100000000001
        1000000000111000000000111000000000111000000000111000000000111000000000111000000000111000000001
  1     1011000000111000000000111000000000111000000000111000000000111000000000111000000000111000000001
  1    10001000000111000000000111000000000111000000000111000000000111000000000111000000000111000000001
111111111011000001110000000000111000000000111000000000111000000000111000000000111000000000111000000001
100000000011000000001110000000111000000000111000000000111000000000111000000000111000000000111000000001
111101111111110100011000000000111000000000111000000000111000000000111000000000111000000000111000000001
111101111111110110001110000000001110000000001110000000001110000000001110000000001110000000001110000001
1100000011011111110001110000000001110000000001110000000001110000000001110000000001110000000001110000001
1000000000000000000000000000000000000000000000000000000000000000000000000000000000000000000000000000001
1111011111111100001110000000001110000000001110000000001110000000001110000000001110000000001110000000001
1100000111010101000111000000000111000000000111000000000111000000000111000000000111000000000111000000001
1100000111010101000111000000000111000000000111000000000111000000000111000000000111000000000111000000001
1111011111111101000111000000000111000000000111000000000111000000000111000000000111000000000111000000001
11110111 1110100001110000000001110000000001110000000001110000000001110000000001110000000001110000000001
11111111 1111100011100000000011100000000011100000000011100000000011100000000011100000000011100000000001
1111111111111111111111111111111111111111111111111111111111111111111111111111111111111111111111111111111
