NO     ./textures/purplestone.xpm
SO ./textures/bluestone.xpm
   WE ./textures/wall_1.xpm
EA ./textures/wall_2.xpm

F 220,100    ,0
C 225,      30,0

1111 111
10001001
10000001
 100N01
10001001
1111 111
