NO ./textures/purplestone.xpm
SO ./textures/bluestone.xpm
WE ./textures/wall_1.xpm
EA ./textures/wall_2.xpm
R 1920 1080

S ./textures/pillar.xpm
F 220,100,0
C 225,30,0

        1111111111111111111111111
        1000000000110000000000001
        10110000011100000020E0001
        1001000000000000000000001
111111111011000001110000000000001
100000000011000001110111111111111
1111011111111101110000001000101
11110111111111011101010010001
11000000110101011100000010001
10002000000000001100000010001
10000000000000001101010010001
1100000111010101111101111001111
11110111 1110101 101111010001
11111111 1111111 111111111111
