NO     ./textures/purplestone.xpm
SO ./textures/bluestone.xpm
WE ./textures/wall_1.xpm
EA ./textures/wall_2.xpm

F 18,127    ,0
C 255,      127,0

111111111111111111111111111111111
1000000E000000000200000000000001
11111111121100000111121101111111
  1  1 1000200200000000000000001
111112111011000001110000000000001
100000000011000001110111111111111
11110111111111011100000010001
11110111111111011101010010001
1100000011011 111101000010001
1000000000001 1011000000100011
1111011111111101110000001000111
11000001110101011111010110011
11000001110101011111010110011
1111011111111101110000000001
11110111 1110101 101111010001
11111111 1111111 111111111111
